..#......................#######
.#########..............#......#
####......#............#########
...........#..........#.........
...........#..........#.........
...........#.........#..........
#############.........#.........
.............#.........#........
............#.#.........###....#
...........#...#......##...#.##.
..........#.....##...#......#...
........##........###......#....
.....###..#...##...#....###.....
..###......###..####..##..#.....
##..........#.......##.....#....
............#...............##..
............#.............##..##
............###############......